11111111111111111111111111111111111111111111111111111
1000010000000000000100000000000000100000000000C000011
10E0000000010000000000C00000001000000000000C000000001
100000000000000C0000000C00010000000000000000000000001
1000100000C000000000000010000000000010000000000001001
10000000000000100000000000000010000000000000000C00001
1000000000000000010000001000000000P000000000000000001
10100000100000C000000000000000000000C0000000000000001
100C000C000000000000000000000000000000000001000000001
101000000000C0000010000001000000000000000000000100001
1000C0C0000000000000000000000000C0000C000000000000001
100100000010000000000C0000001000000000000001000C00001
10000000000000000000000000000000000000000000000000001
100000C00F0000000000000000001000000000C00000100100001
10000000000001000000000000000000100000000000000000001
11111111111111111111111111111111111111111111111111111
